; EASY 1

## # ####
##   ##  .
##        #
#      #  #
###  ###  #
  #  #    #
 ## ## # ##
 #      ##
 @     ##
 #######