; DIFFICULT 5

############
#     #### .
# ##       #
#  ####### #
#        # #
###### #   #
#      # ###
# ######   #
@        ###
############