; EASY 2

#########
#       .
#   ### #
#   #   #
#   #   #
#   ### #
#       #
#       #
@       #
#########
