; EASY 3

##########
#        .
#  ####  #
#        #
#  ####  #
#        #
#   ###  #
#        #
@        #
##########
