; EASY 4

           #####
          ##   .
          #    #
    ####  #   ##
    #  ####   #
    #         #
   ## ##      #
   #   #      #
   #   #      #
##### #########
#        #
#        #
@   ######
#####
