; EASY 5

############
#          .
#  #####   #
#          #
###   #### #
#          #
###  ####  #
#          #
@          #
############

