; DIFFICULT 1

############
#          .
#  ######  #
#       #  #
###  ## #  #
#     #    #
### ### ### #
#       #   #
#####   #####
@           #
############
