; DIFFICULT 2

############
#   ####   .
#     #    #
###   #### #
#          #
##### ###  #
#       #  #
#####   #  #
#    #  ####
@          #
############
