; DIFFICULT 3

############
# #   #     .
# ## #### ###
#     #     #
##### ##### #
#  #        #
#  # ###### #
@           #
#############
