; DIFFICULT 4

############
#    ####  .
# #     ## #
# ### #    #
#   # ######
### #      #
#    ### ###
#######    #
 @         #
############
